BGRTRGTRBGRB
GBGGBTGGTTBB
RGRBGARRRRTB
RTBGGRGGBRTB
TBRBRTRBRGRB
ETTTTTTTTTTG
RTRTRTRTRTRT

RRRRRRRRRRLLLLLLLLL