ATGRGGTBRGTG
RRTGGTRTRBRG
GRGGGBGTRTTG
GGTRTGGTTBTB
GBRGTRGGGGRT
BBGGRBRGTTRT


