GGGGRRGGG1
GGGGRRGGGG
GGGGRRGGGG
GGGGRRGGGG
GGGGGGGGGG
GGGGGGGGGG
GGGGRRGGGG
GGGGRRGGGG
GGGGRRGGGG
2GGGRRGGGG
