GGGGGGGGG1
GGGGRRGGGG
GGGRRRRGGG
GGGGRRGGGG
GGGGGGGGGG
GGGGGGGGGG
GGGGRRGGGG
GGGRRRRGGG
GGGGRRGGGG
2GGGGGGGGG
