GGGGGGGGG1
GRGGGGGGRG
GGRGGGGRGG
GGGRGGRGGG
GGGGGGGGGG
GGGGGGGGGG
GGGRGGRGGG
GGRGGGGRGG
GRGGGGGGRG
2GGGGGGGGG